NO ./textures/f.xpm
SO ./textures/r.xpm
WE ./textures/l.xpm
EA ./textures/o.xpm

F 220,100,0
C 225,30,0

        1111111111111111111111111
        1000000000110000000000001
        1011000001110000000000001
        100100000222W000010000001
111111111011000001110000000000001
100000000011000001110001001111111
1111011111111211100000000001
1111011111111121101012100001
11000000110101011100000000001
10000000000000001100000000001
10000000000000001101022200201
110000011101010111110000000011
11110111 1110101 100000000001
11111111 1111111 111111111111
